###########################################################
#                                                         #
#                                                         #
#                                                         #
#                                                         #
#                                                         #
####################################################      #
#                                                         #        
#                                                         #
#                                                         #
#                                                         #
#                                                         #
#                                                         #
#                                                         #
#                                                         #
#                                                         #
#                                                         #
#                                                         #
#                                                         #
#                                                         #
#                                                         #
#           ##########################                    #
#                                                         #
#                                                         #
#                                                         #
#                                                         #
#                                                         #
#                                                         #
#                                                         #
#                                                         #
#                                                         #
#                                ##########################
#                                                         #
#                                                         #
#                                                         #
#                                                         #
#                                                         #
#                                                         #
###########################################################